++++++++++++++++++++++++++++++++++++++++++++++++++++++++++++++++++++++++++++++++++++++++++++++++++++
+------------------------+-------------------------------------------------------------------------+
+p-----------------------+-----------------------------------------+-------------------------------+
++++++++-----------------+----------------+++++++++++--------------+-------------------------------+
+------------------------+-----------------------------------------+-------------------------------+
+-----------+++++++------+------++---------------------------------+-------------------------------+
+-----------------+------+------++---------------------------------+-------------------------------+
+-----------------+-------------++---------------------------------+-------------------------------+
+-----------------+-------------++---------------------------------+-------------------------------+
++++++++++++++++++++++++++++++++++++++++++++++++++++++++++++++++++++++++++++++++++++++++++++++++++++